11 11
###########
# S #G#   #
# C # ##-##
##-## |   #
#   ###-###
###-##   E#
#    # ## #
#E   #    #
##-###-##-#
#   |  #  #
###########
